30 30
TTTTTTTTTTTTTTTTTTTTTTTTTTTTTT
T....L.....TT..........T......
T....+.....TT..........T......
T..........TT..........T......
T..........TT..........T......
T..........TT..........T......
T..........TT..........T......
T..........TT..........T......
T..........TT..........T......
T..........TT..........T......
T..........TT..........T......
T....+.....TT..........T......
T..........TT..........T......
T..........TT..........T......
T..........TT..........T......
T..........TT..........T......
T..........TT..........T......
T..........TT..........T......
T..........TT..........T......
T..........TT..........T......
T....+.....TT..........T......
T..........TT..........T......
T..........TT..........T......
T..........TT..........T......
T..........TT..........T......
T..........TT..........T......
T..........TT..........T......
T..........TT..........T......
T..........TT..........T......
TTTTTTTTTTTTTTTTTTTTTTTTTTTTTT