10 10
TTTTTTTTTT
T........T
T........T
T........T
T...L....T
T........T
T........T
T........T
T........T
TTTTTTTTTT